congratulations, step on road -> 54
000000000000000000000000000000000
000000000000000000000000000000000
0I+++             0            00
0000+00 00 0000 0 0 0 00000000 00
0000+0000000000 0 0 0 00000000 00
0000+000+++++00 0 0 0 00    00 00
0000+000+000+00 0 0 0 00 00 00 00
0000+000+000+00 0   0 00 00 00 00
0000+000+000+00000000    00 00 00
0000+++++ 00++++  000000000 00 00
00   0000 00000+0000000+++++0  00
0000 0000 00000+0000   +000+00000
0000 0000 00000++++0000+000++++E0
0000      0     00++++++000000000
000000000000000000000000000000000
000000000000000000000000000000000

1 start, -1 finish, -2 space, 0 wall, 2 3 4 ... roads.
  0  0  0  0  0  0  0  0  0  0  0  0  0  0  0  0  0  0  0  0  0  0  0  0  0  0  0  0  0  0  0  0  0
  0  0  0  0  0  0  0  0  0  0  0  0  0  0  0  0  0  0  0  0  0  0  0  0  0  0  0  0  0  0  0  0  0
  0  1  2  3  4  5  6  7  8  9 10 11 12 13 14 15 16 17  0 29 30 31 32 33 34 35 36 37 38 39 40  0  0
  0  0  0  0  5  0  0  8  0  0 11  0  0  0  0 16  0 18  0 28  0 32  0  0  0  0  0  0  0  0 41  0  0
  0  0  0  0  6  0  0  0  0  0  0  0  0  0  0 17  0 19  0 27  0 33  0  0  0  0  0  0  0  0 42  0  0
  0  0  0  0  7  0  0  0 19 20 21 22 23  0  0 18  0 20  0 26  0 34  0  0 43 44 45 46  0  0 43  0  0
  0  0  0  0  8  0  0  0 18  0  0  0 24  0  0 19  0 21  0 25  0 35  0  0 42  0  0 47  0  0 44  0  0
  0  0  0  0  9  0  0  0 17  0  0  0 25  0  0 20  0 22 23 24  0 36  0  0 41  0  0 48  0  0 45  0  0
  0  0  0  0 10  0  0  0 16  0  0  0 26  0  0  0  0  0  0  0  0 37 38 39 40  0  0 49  0  0 46  0  0
  0  0  0  0 11 12 13 14 15 16  0  0 27 28 29 30 31 32  0  0  0  0  0  0  0  0  0 50  0  0 47  0  0
  0  0 14 13 12  0  0  0  0 17  0  0  0  0  0 31  0  0  0  0  0  0  0 45 46 47 48 49  0 49 48  0  0
  0  0  0  0 13  0  0  0  0 18  0  0  0  0  0 32  0  0  0  0 47 46 45 44  0  0  0 50  0  0  0  0  0
  0  0  0  0 14  0  0  0  0 19  0  0  0  0  0 33 34 35 36  0  0  0  0 43  0  0  0 51 52 53 54 -1  0
  0  0  0  0 15 16 17 18 19 20  0 38 37 36 35 34  0  0 37 38 39 40 41 42  0  0  0  0  0  0  0  0  0
  0  0  0  0  0  0  0  0  0  0  0  0  0  0  0  0  0  0  0  0  0  0  0  0  0  0  0  0  0  0  0  0  0
  0  0  0  0  0  0  0  0  0  0  0  0  0  0  0  0  0  0  0  0  0  0  0  0  0  0  0  0  0  0  0  0  0
